{
    "compose_ids": [
        134221103, 
        134234265, 
        134254594, 
        134257373, 
        134223212, 
        134230009, 
        134260274, 
        134248927, 
        134272290, 
        134227407, 
        134243786, 
        134251142, 
        134251848, 
        134253630, 
        134268733, 
        134280690, 
        134236925, 
        134233099, 
        134234277, 
        134269632, 
        134239186, 
        134233162, 
        134249505, 
        134219033, 
        134275810, 
        134274424, 
        134223729, 
        134223963, 
        134254221, 
        134250872, 
        134237485, 
        134244874, 
        134221600, 
        134250456, 
        134222442, 
        134274493, 
        134230220, 
        134251788, 
        134268598, 
        134228524, 
        134222290, 
        134265711, 
        134262547, 
        134253839, 
        134263249, 
        134255280, 
        134258638, 
        134230768, 
        134225393, 
        134237910, 
        134222583, 
        134236613, 
        134282753, 
        134222526, 
        134282967, 
        134258463
    ], 
    "item_id_seed": 29
}